%%%%%%%%%%%%%%%%%%%
%                 %
%                 %
%   G             %
%                 %
%                 %
%                 %
%                 %
%                 %
%                 %
%                 %
%                P%
%%%%%%%%%%%%%%%%%%%
% % % % %%%%%%%%%%%
%%%%%%%%%%%%%%%%%%%