%%%%%%%%%%%%%%%%%%%
%   G             %
%                 %
%                 %
%                 %
%                 %
%                 %
%                 %
%                 %
%   P             %
%                 %
%                 %
%%%%%%%%%%%%%%%%%%%
% % % % %%%%%%%%%%%
%%%%%%%%%%%%%%%%%%%