%%%%%%%%%%%%%%%%%%%
%P                %
%                 %
%   G             %
%                 %
%                 %
%                 %
%                 %
%                 %
%                 %
%                 %
%                 %
%%%%%%%%%%%%%%%%%%%
% % % % %%%%%%%%%%%
%%%%%%%%%%%%%%%%%%%