%%%%%%%%%%%%%%%%%%%
%                 %
%                 %
%G               P%
%                 %
%                 %
%                 %
%                 %
%                 %
%                 %
%                 %
%                 %
%%%%%%%%%%%%%%%%%%%
% % % % %%%%%%%%%%%
%%%%%%%%%%%%%%%%%%%