%%%%%%%%%%%%%%%%%%%
%                 %
%                 %
%             G   %
%                 %
%                 %
%                 %
%                 %
%                 %
%                 %
%                 %
%P                %
%%%%%%%%%%%%%%%%%%%
% % % % %%%%%%%%%%%
%%%%%%%%%%%%%%%%%%%