%%%%%%%%%%%%%%%%%%%
%                 %
%                 %
%                 %
%                 %
%                 %
%                 %
%                 %
%                 %
%             G   %
%                 %
%                P%
%%%%%%%%%%%%%%%%%%%
% % % % %%%%%%%%%%%
%%%%%%%%%%%%%%%%%%%