%%%%%%%%%%%%%%%%%%%
%                 %
%                 %
%P               G%
%                 %
%                 %
%                 %
%                 %
%                 %
%                 %
%                 %
%                 %
%%%%%%%%%%%%%%%%%%%
% % % % %%%%%%%%%%%
%%%%%%%%%%%%%%%%%%%